+---+---+---+---+---+---+---+---+---+---+---+
|               |                           |
+   +   +---+   +   +---+---+---+---+---+   +
|   |   |   |   |                       |   |
+   +---+   +   +   +---+---+---+---+   +   +
|   |       |                       |   |   |
+   +   +   +   +---+---+---+---+   +   +   +
|   |   |   |                   |   |   |   |
+   +   +   +---+---+---+---+   +   +   +   +
|   |   |                   |   |   |   |   |
+   +   +   +   +   +---+   +   +   +   +   +
|   |               | x |   |   |   |   |   |
+   +   +---+---+---+   +   +   +   +   +   |
|   |   |               |   |   |   |   |   |
+   +   +   +---+---+---+   +   +   +   +   |
|   |   |   |               |   |   |   |   |
+   +   +   +   +---+---+   +   +   +   +   +
|   |   |   |               |   |   |   |   |
+   +   +   +---+---+---+---+   +   +   +   +
|   |   |                       |   |   |   |
+   +   +---+---+---+---+---+---+   +---+   +
|                                           |
+---+---+---+---+---+---+---+---+---+---+---+